                                                                                                    
              •                                                                                     
              ▒                                                                                     
              ▒▒                                                                                    
           ▒▒▒ ░▒▒▒                                                                                 
         ▓▒ ░░ ░░  ▒▒                                                                               
        ▓░ ░░   ░  ░░▒             ¥¥                 ¥¥¥                                           
        ▓░ ░░   ░   ░▓               ¥                                                              
        ▓░ ░░ ▓ ░░  ░▓                                                    ¥ ¥                       
       •▓░ ░░ ▓▓░░  ░▓    ♀ ♀            ■ ░░░░░░░░░░░░░░░░░                                        
      ••▓░ ░░ ▓▓▓░  ░▓••  ♀ ♀♀     ░░░░░░░░                ░░                                       
                              ░░░░░                         ░░░                                     
   ♀♀ ░░░░░░░░░░░░░░░░░░░░░░░░░                               ░                                     
                                           •████▓██           ░░             ▒▒▒▒▒▒▒▒▒              
        ░░░░░░░░░                         █████▓▓▓██•░         ░            ▒░•  ░  ••▒             
                ░░░░░                 ░░░░█████▓▓▓▓▓██░        ░░    ¥     ▒•         ░▒            
                    ░░░             ░░  ██████▓▓▓▓▓▓███░        ░░    ¥    ▒•         •▒            
                     •░░          ░░░   ████▓▓▓▓▓▓▓▓▓██░         ░        ░▒     ▒     ▒            
       ¥               ░░      ■ ░░ █▓▓██████████▓█████░░        ░         ▒     ▒     ▒░           
                        ░       ░░ █▓▓▓▓▓█████████████  ░░     ■ ░░        ▓    ▒ ▒    ▓            
                  ¥     •░     ░░ ██▓▓▓▓███   ▒▒▒     ¥¥ ░░       ░        ░▓   ▒ ▒   ▓             
                         ░     ░  ██▓▓▓████   ▒▒▒         ░░░     ░░         ▓▓▓▒▓▒▓▓▓░             
                         ░     ░  ████████    ▒▒▒           ░░     ░   ♀♀♀♀    ▒   ▒                
                         ░     ░     ▒▒       ▒▒▒             ░    ■░░♀       ▀▀▀▀▀▀▀               
            ¥ ¥          ░     ░     ▒▒  ▓▓▓▓▓▓▒▒        █▓▓▓█░░     ░♀░░                           
                         ░     ░░    ▒▒ ███████       █▓▓▓▓▓██░░     ♀  ░░░░░░░░░   ░░░░░           
                    ¥    ░      ░       ▀     ▀     ███████░░░░                 • ░░                
                     ¥   •      ░░                 ▒▒████░░░                    ░░░                 
        ¥               ░░       ░░          ¥      ░░                        ░░░                   
                        ░         ░░░░            •░                     • ░░■                      
                        ░          ■ ░░░░░░░░░   ░░           ♀  ♀     ░░░░░                        
                       ░░                     ░░░        ░░░░░░░░░░░░░░                             
           ▓░░░░░░░▒   ░░                              ░░░                       ¥  ¥               
           ▓▒░░░░░░░▒   ░░░                           ░░                                            
           ▓▓▒░░░░░░░▒    ░                           ░■                                            
           ▓       ▓      ░░                          ░        ♀ ♀      ¶¶¶¶¶¶                      
           ▓▓░░░░░░░░░ ♀ ♀░░                          ░                ¶      ¶                     
           ▓▓░▒▒▒▒▒▒░░  ♀♀░♀     ░░░░░░░░░░░░         ░               ¶  ▓▓▓▓  ¶                    
         ░░▓▓░░░░░░░░░       ░░░░    •      •░                        ¶ ▓████▓ ¶                    
                         •░░░                    ♣  ♣♣  ♣             ¶  ████  ¶       ¥            
           ░░░░░░░░░░░░░░░            ♀ ♀      ♣ ▒▒▒▒▒▒▒▒ ♣            ¶      ¶                     
                                         ♀     ▒▒▒▒▒▒▒▒▒▒▒▒             ¶¶¶¶¶¶                      
                                         ░░░░░█▒▒        ▒██░░░░░  ¥                                
           ¥    ¥                      ░     ██▒          ██ █    ░            ¥                    
                           ¥¥         ░     █ │▒    ↓↓    ▒│ █     ░            ¥¥                  
                               ¥ ¥    ░     │ │▒          ▒ │      ░                                
                                                    ══                                              
                                                   ──═─                                             
                                                                                                    
                                                                                                    